+-+-+-+-+-+
|         |
+ + +-+ +-+
| |   | | |
+ + +-+ + +
| |   |   |
+ + +-+ + +
| | |   | |
+ + +-+ + +
| |       |
.-+-+-+-+-+